111111111111111111111111111111
100000000220000000000000000001
100333333333330000000000000001
133330002200333300000000000001
133000002220003333300000000001
100000000220000003330000000001
100000000022200000333000000001
100000000222222000033000000001
100000002222222200033000000001
111111111111111111111111111111